acl	acl	Clauses
acl:assoccoll	acl	Clauses
acl:cleft	acl	Clauses
acl:ger	acl	Clauses
acl:inf	acl	Clauses
acl:part	acl	Clauses
acl:poss	acl	Clauses
acl:prc	acl	Clauses
acl:rel	acl	Clauses
acl:relcl	acl	Clauses
acl:subj	acl	Clauses
advcl	advcl	Clauses
advcl:cond	advcl	Clauses
advcl:coverb	advcl	Clauses
advcl:sp	advcl	Clauses
advcl:svc	advcl	Clauses
advcl:tcl	advcl	Clauses
advmod	advmod	ModifierWords
advmod:cmp	advmod	ModifierWords
advmod:cmpstandard	advmod	ModifierWords
advmod:df	advmod	ModifierWords
advmod:discourse	advmod	ModifierWords
advmod:emph	advmod	ModifierWords
advmod:epist	advmod	ModifierWords
advmod:evid	advmod	ModifierWords
advmod:inf	advmod	ModifierWords
advmod:locy	advmod	ModifierWords
advmod:mode	advmod	ModifierWords
advmod:multprf	advmod	ModifierWords
advmod:neg	advmod	ModifierWords
advmod:obl	advmod	ModifierWords
advmod:phrase	advmod	ModifierWords
advmod:q	advmod	ModifierWords
advmod:qnt	advmod	ModifierWords
advmod:quant	advmod	ModifierWords
advmod:que	advmod	ModifierWords
advmod:sup	advmod	ModifierWords
advmod:tfrom	advmod	ModifierWords
advmod:tlocy	advmod	ModifierWords
advmod:tmod	advmod	ModifierWords
advmod:to	advmod	ModifierWords
advmod:tto	advmod	ModifierWords
amod	amod	ModifierWords
amod:att	amod	ModifierWords
amod:attlvc	amod	ModifierWords
amod:mode	amod	ModifierWords
amod:obl	amod	ModifierWords
appos	appos	Nominals
aux	aux	FunctionWords
aux:caus	aux	FunctionWords
aux:cop	aux	FunctionWords
aux:neg	aux	FunctionWords
aux:obj	aux	FunctionWords
aux:pass	aux	FunctionWords
aux:q	aux	FunctionWords
aux:subj	aux	FunctionWords
case	case	FunctionWords
case:acc	case	FunctionWords
case:aspect	case	FunctionWords
case:circ	case	FunctionWords
case:dec	case	FunctionWords
case:gen	case	FunctionWords
case:loc	case	FunctionWords
case:pref	case	FunctionWords
case:suff	case	FunctionWords
case:voc	case	FunctionWords
cc	cc	Coordination
cc:preconj	cc	Coordination
ccomp	ccomp	Clauses
ccomp:obj	ccomp	Clauses
ccomp:obl	ccomp	Clauses
ccomp:pmod	ccomp	Clauses
ccomp:pred	ccomp	Clauses
clf	clf	FunctionWords
compound	compound	MWE
compound:abs	compound	MWE
compound:conjv	compound	MWE
compound:dir	compound	MWE
compound:ext	compound	MWE
compound:lvc	compound	MWE
compound:nn	compound	MWE
compound:plur	compound	MWE
compound:preverb	compound	MWE
compound:prt	compound	MWE
compound:redup	compound	MWE
compound:smixut	compound	MWE
compound:svc	compound	MWE
compound:vo	compound	MWE
compound:vv	compound	MWE
conj	conj	Coordination
conj:discourse	conj	Coordination
conj:extend	conj	Coordination
conj:svc	conj	Coordination
cop	cop	FunctionWords
cop:belong	cop	Coordination
cop:exist	cop	Coordination
cop:own	cop	Coordination
csubj	csubj	Clauses
csubj:cleft	csubj	Clauses
csubj:cop	csubj	Clauses
csubj:pass	csubj	Clauses
dep	dep	Other
dep:ig	dep	Other
det	det	FunctionWords
det:def	det	FunctionWords
det:numgov	det	FunctionWords
det:nummod	det	FunctionWords
det:poss	det	FunctionWords
det:predet	det	FunctionWords
det:quant	det	FunctionWords
discourse	discourse	ModifierWords
discourse:emo	discourse	ModifierWords
discourse:filler	discourse	ModifierWords
discourse:sp	discourse	ModifierWords
dislocated	dislocated	Nominals
dislocated:cleft	dislocated	ModifierWords
expl	expl	Nominals
expl:impers	expl	Nominals
expl:pass	expl	Nominals
expl:poss	expl	Nominals
expl:pv	expl	Nominals
fixed	fixed	MWE
flat	flat	MWE
flat:foreign	flat	MWE
flat:name	flat	MWE
flat:repeat	flat	MWE
flat:title	flat	MWE
goeswith	goeswith	Special
goeswith:alt	goeswith	Special
iobj	iobj	Nominals
iobj:agent	iobj	Nominals
iobj:caus	iobj	Nominals
list	list	Loose
mark	mark	FunctionWords
mark:adv	mark	FunctionWords
mark:advb	mark	FunctionWords
mark:comp	mark	FunctionWords
mark:prt	mark	FunctionWords
mark:rel	mark	FunctionWords
mark:relcl	mark	FunctionWords
nmod	nmod	Nominals
nmod:abl	nmod	Nominals
nmod:abs	nmod	Nominals
nmod:agent	nmod	Nominals
nmod:appos	nmod	Nominals
nmod:arg	nmod	Nominals
nmod:att	nmod	Nominals
nmod:attlvc	nmod	Nominals
nmod:bahuv	nmod	Nominals
nmod:cau	nmod	Nominals
nmod:clas	nmod	Nominals
nmod:cmp	nmod	Nominals
nmod:cmpstandard	nmod	Nominals
nmod:comp	nmod	Nominals
nmod:dat	nmod	Nominals
nmod:det	nmod	Nominals
nmod:dsubj	nmod	Nominals
nmod:exist	nmod	Nominals
nmod:gen	nmod	Nominals
nmod:gmod	nmod	Nominals
nmod:gobj	nmod	Nominals
nmod:gsubj	nmod	Nominals
nmod:instr	nmod	Nominals
nmod:name	nmod	Nominals
nmod:npmod	nmod	Nominals
nmod:obl	nmod	Nominals
nmod:obllvc	nmod	Nominals
nmod:own	nmod	Nominals
nmod:part	nmod	Nominals
nmod:pmod	nmod	Nominals
nmod:pos	nmod	Nominals
nmod:poss	nmod	Nominals
nmod:ref	nmod	Nominals
nmod:tmod	nmod	Nominals
nsubj	nsubj	Nominals
nsubj:ascriptive	nsubj	Nominals
nsubj:belong	nsubj	Nominals
nsubj:caus	nsubj	Nominals
nsubj:cop	nsubj	Nominals
nsubj:exist	nsubj	Nominals
nsubj:exit	nsubj	Nominals
nsubj:expl	nsubj	Nominals
nsubj:forpurpose	nsubj	Nominals
nsubj:lvc	nsubj	Nominals
nsubj:nc	nsubj	Nominals
nsubj:own	nsubj	Nominals
nsubj:pass	nsubj	Nominals
nsubj:prspron	nsubj	Nominals
nsubj:qnt	nsubj	Nominals
nummod	nummod	Nominals
nummod:entity	nummod	Nominals
nummod:gov	nummod	Nominals
obj	obj	Nominals
obj:agent	obj	Nominals
obj:cau	obj	Nominals
obj:dir	obj	Nominals
obj:emph	obj	Nominals
obj:lvc	obj	Nominals
obj:prspron	obj	Nominals
obl	obl	Nominals
obl:agent	obl	Nominals
obl:arg	obl	Nominals
obl:cau	obl	Nominals
obl:gmod	obl	Nominals
obl:loc	obl	Nominals
obl:npmod	obl	Nominals
obl:own	obl	Nominals
obl:patient	obl	Nominals
obl:prep	obl	Nominals
obl:tmod	obl	Nominals
orphan	orphan	Special
orphan:obj	orphan	Special
orphan:obl	orphan	Special
orphan:subjassoccoll	orphan	Special
parataxis	parataxis	Loose
parataxis:deletion	parataxis	Loose
parataxis:discourse	parataxis	Loose
parataxis:hashtag	parataxis	Loose
parataxis:insert	parataxis	Loose
parataxis:newsent	parataxis	Loose
parataxis:nsubj	parataxis	Loose
parataxis:obj	parataxis	Loose
parataxis:restart	parataxis	Loose
punct	punct	Other
reparandum	reparandum	Special
root	root	Other
vocative	vocative	Nominals
vocative:mention	vocative	Nominals
xcomp	xcomp	Clauses
xcomp:adj	xcomp	Clauses
xcomp:ds	xcomp	Clauses
xcomp:exist	xcomp	Clauses
xcomp:obj	xcomp	Clauses
xcomp:pred	xcomp	Clauses
xcomp:sp	xcomp	Clauses
